****************************************
*--------------  Finish  --------------*
*                                      *
*                                      *
*                                      *
*                                      *
*''''''''''''''''''''''''''''''''''''''*
*¡¡¡¡¡¡¡¡¡¡¡¡¡¡¡¡¡¡¡¡¡¡¡¡¡¡¡¡¡¡¡¡¡¡¡¡¡¡*
*                                      *
*                                      *
*                                      *
*                                      *
*--------------   Start  --------------*
****************************************
